###############################
#.#.#..#.##.##..#..#.....#.#.##
#....##.#.##.##.##.....#......#
#.#.#.#........##...#....#.#.##
##......#.###.#..#.#.....##...#
##.##.##.#.#........##.##.....#
#....#......#.####.#..#..#....#
##.#..#.#....#......#.##.##.#.#
#.#..#...####...#.##.......#.##
#...#.....#.#.##.#.##.####...##
#.##...##.#....#.......#.#.#..#
#..##..#....#.#..#.#.##...##.##
#..#...##.#.##....#.#.#......##
##.##.#.##.#.#...#....#..##.#.#
##.###.......#..#....##.#..#..#
#...#...#..#....#...#.......#.#
##.#.#..##.#.#.#.##..#.#.##...#
#....##..#..#.#.....##.....##.#
##.#....##.#....#.#.#.#..#...##
#..#.#.##.....#..#.....#...#..#
###############################
