###############################
#.#.####..###...#.#......#....#
#....##.#.#.###.......#...##..#
#.#.#.#.........#.#.#.##.#....#
##......#.#.#...##...##.......#
###.#.##.#.##..##...#..##.....#
#....#......#......#..#..#....#
####..#..##.###.#...#.#..##.#.#
#.#..#...#.#....#.##.......#.##
#....#........##.#.##.#.#....##
#.#.#....#.#...#.......#.#.#..#
#...##...##...#..#.#.##...#..##
#.#..###..#.##...##...#......##
##....#.##.#.#....#.##...##.#.#
##.#.#.......#.....#..#.#.#...#
#...#...#.##....#....#.....#..#
##.#.#..##..#..#.##..#.#.##.#.#
#....##..#.........##.......#.#
#..#....#.#...#.#...###..#.####
#.#..#.#.......#.......#.#....#
###############################