###############################
#.....#......#.#.#..#.##.#.####
##.....#..........##.#.......##
#.......#...#.#.#.#....#.#...##
#...#...####.##.#.##.##.##.##.#
#...#..#.#....#.......#.#...#.#
##.#.......#....###.##.....##.#
#...#..#.#.##.#.##.#......#.#.#
#..#..#.####..##......#.......#
#.#.#....##.##...#.#.#.#.##...#
#.#...#.#....#....#.#...##..#.#
#..#.#..#.#.......#.......#...#
#...#.#..#.#.#.#.#..##.#...#..#
#..#..#.....#.#.#..#..###.#...#
#......#............#..#..##..#
#..##.#..###.##..#.#...#...#..#
###....##.#.##.##.#.#..#....###
#.....#..............#..##..###
#.#.....#.#.#.#..###.....#....#
#.....#..#...#..#....#..#...#.#
###############################
