###############################
#.#.#.####..#####..#.....#.#.##
#.....#.#.##.##..#.....#......#
#.#.#.#........##...#....#.#.##
#.......#.###.#..#.#.....##...#
##.##.##.#.#........##.##.#...#
#....#......#.####.#..#.......#
##.#.##.#....#......#.##.##.#.#
#.#..#...####...#.##....##.#.##
#...#.....#.#.##.#.##.#......##
#..#...##.#....#.......###.#..#
#..##..#....#.#..#.#####..#..##
#.##...##.#.##....#..#.....#.##
#...#.#.##.#.#...#....#.##.#..#
##.###.......#.##..#.#..#....##
#...#...##.#....#..#..#..#.#..#
##...##.#..###.#.##..#..#.##..#
#.....#..#..#.#......#.....##.#
##.#....##......#.....#.#....##
#...##.##...#.#.##...#.....#..#
###############################
