###############################
#.#.#..######..#...#.#..#.....#
#....##.#.##.##......#..#.....#
#.#.#.#........##..#..........#
##......#.###.#..#.#...#.#....#
##.##.##.#.#........#####.....#
#....#....#.#.####.#..#..#..#.#
##.#..#.#....#......#.##.##.###
#.#..##...#.#...#.##.......#.##
##..###..#...#.#.#.##.####...##
#.#.##..#.##...#.......#.#.#..#
#...#.......#.#..#.#.##...##.##
#.#..#.##.#.##...##.#.#......##
##....#.##.#.#....#...#..##.###
##.#.#.......#....#.#...##.#.##
#...#...#.##....#.##......##.##
##.#.#..##..#..#.##.###..####.#
#....##..#....##..###.#......##
#..#....##..#.##...#.##..#...##
#.#..#.##.###..#.#.####.#..#..#
###############################
