###############################
#.....#...##.#.#..#....#.#.####
##..##.#..........##.#.......##
#.......#...##....#...##.#...##
#...##.#####.##.#.##.##.##.##.#
#..##..#.#....#.......#.#...#.#
##..#......#....#.#.##.....##.#
#..##..#.#.##.#.##.#......#.#.#
#.##..#.####..##......#.......#
#.#.#....##.##...#.#.#.#.##...#
#.#...#.#....#....###...##..#.#
#..#.#..#.#.......#.......#...#
#.#.#.#..#.#.#.#.#...#.#...#..#
#.....#.....#.#.#..##.###.#...#
#.#....#............#..#..##..#
#..##.#..###.##..#.##..#...#..#
#.##...##.#.##.##.#.#..#....###
##.#..##.............#..##..###
##...##.#.#.#..#.##......#....#
##.........#..#..#...#.##...#.#
###############################
