###############################
#.#.#..###..##...#.#.##.#....##
#....##.#.##.##......#..#.#...#
#.#.#.#........##..#.......#.##
##......#.###.#..#.#.#.#.##...#
##.##.######........#####.....#
#....#....#.#.####.#..#..#....#
##.#..#......#......#.##.##.#.#
#.#..#....#.#...#.##.......#.##
##..#...##...#.#.#.##.####...##
#.#.##.#..##...#.......#.#.#..#
#...#.......#.#..#.#.##...##.##
#.#..#.#..#.##...##.#.#......##
##....#.##.#.#....#...#..##.###
##.#.#.......#....##.#..#..#.##
#...#...#.##....#.#..#....#...#
##.#.#..###.#..#..#..##..#.#.##
#....##..#....#.##.#..#.......#
#..#....#..##.........#..##.###
#.#..#.#.#.#...#.##.#..#..#...#
###############################
