###############################
#.#.##.#..###...#.#......#....#
#....##.#.#.###.......#...#..##
#.#.#.#.........#.#.#.##.##...#
##......#.#.#...##...##......##
#.#.#.##.#.##..##...#..##..#..#
##...##.....#......#..#..#....#
##.#..#..##.###.#...#.#..##.#.#
#.#..#..##.#....#.##.......#.##
#....#........##.#.##.#.#....##
#.#.#....#.#...#.......#.#.#..#
#...##...##...#..#.#.##...#..##
#.#..#.#..#.##...##...#......##
##....#.##.#.#....#.##...##.#.#
##.#.#.......#.....#..#.#.#...#
#...#...#.##....#....#.....#..#
##.#.#..##..#..#.##..#.#.##...#
#....##..#.........##......#..#
#..#....#.#...#.#....##..#..###
#.#..#.#...........#...#..#...#
###############################
