###############################
#.#..###...##.#.#.#......#...##
#....##.#.#.##........#...#...#
#.#.#.#.......#.#.#.#..#.##...#
##......#.#.#...##...##....#..#
##.##.##.#.#...#.#..#..##...#.#
#....#.....####....#..#..#....#
##.#..#.##..##..#.#.#.##.##.#.#
#.#..#...#......#.##.......#.##
#....##.##..#.##.#.##.####...##
#.#.#.#.##.#...#.......#.#.#..#
#...#.....#...#..#.#.##...##.##
#.#..#.#..#.##...##...#......##
##....#.##.#.#....##.#...##.#.#
##.#.#.......#.....#.##.#..#..#
#...#...#.##....#.#.#.......#.#
##.#.#..##..#..#.##..#.#.##...#
#....##..#.........#.#.....##.#
#..#....##..#.#.#.#...##.#...##
#.#..#.#.......#.....#.....#..#
###############################
