###############################
#.#.##.#.####.#...#.##..###...#
#....##...#.###...........#...#
#.#.#.#.........#...#.##.#..#.#
##......#.#.#...###..##.......#
#.#.#.##.#.###..#...#..##.....#
###..##.....#......#..#..#.#..#
##.#..#..##.###.#...#.#..##.#.#
#....#...#.#....#.##.......#.##
#..#.##.#.....##.#.##.#.#....##
#.#.##.........#.......#.#.#..#
#...#.....#...#..#.#.##...#..##
#.#..#.#.##.##...##...#......##
##....#.##.#.#....#.##...##.#.#
##.#.#.......#.....#..#.#.#...#
#...#...#.##....#....#.....#..#
##.###..##..#..#.##..#.#.##...#
##....#..#.........##......#..#
#..#....#.#...#.#....##..#..###
#.#..#.#...........#...#..#...#
###############################
