###############################
#.#..###...#..#.#.#......#....#
#....##.#.#.##........#...##..#
#.#.#.#.......#.#.#.#..#.#....#
##......#.#.#...##...##....#..#
##.##.##.#.#...#.#..#..##.....#
#....#.....####....#..#..#....#
##.#..#.##..##..#.#.#.##.##.###
#.#..#...#......#.##.......#.##
#....##.##..#.##.#.##.####...##
#.#.#.#.##.#...#.......#.#.#..#
#...#.....#...#..#.#.##...##.##
#.#..#.#..#.##...##...#......##
##....#.##.#.#....##.#...##.#.#
##.#.#.......#.....#.##.#..#..#
#...#...#.##....#...#.......#.#
##.#.#..##..#..#.###.#.#.##...#
#....##..#.........#.#.....##.#
#..#....###...#.#.#...#..#...##
#.#..#.#.......#.......#...#..#
###############################
