###############################
#.#.##.#..###...#.#......##...#
#....##.#.#.###.......#...##.##
#.#.#.#.........#.#.#.##.#....#
##......#.#.#...##...##.......#
###.#.##.#.##..##...#..##.....#
##...##.....#......#..#..#....#
##.#..#..##.###.#...#.#..##.#.#
#.#..#..##.#....#.##.......#.##
#....#........##.#.##.#.#....##
#.#.#....#.#...#.......#.#.#..#
#...##...##...#..#.#.##...#..##
#.#..#.#..#.##...##...#......##
##....#.##.#.#....#.##...##.#.#
##.#.#.......#.....#..#.#.#...#
#...#...#.##....#....#.....#..#
##.#.#..##..#..#.##..#.#.##.#.#
#....##..#.........##.......#.#
#..#....#.#...#.#...###..#.####
#.#..#.#.......#.......#.#....#
###############################
