###############################
#...#.##...##.#.#.#......#....#
#....##.#.#.###.......#...##..#
#.#.#.#.........#.#.#.##.#....#
##......#.#.#...##...##.......#
##.##.##.#.#...##...#..##.....#
#....###...#.......#..#..#....#
##.#..#..#..###.#...#.##.##.#.#
#.#..#...#.#....#.##.......#.##
#....#..#.....##.#.##.####...##
#.#.#....#.#...#.......#.#.#..#
#...#....##...#..#.#.##...##.##
#.#..#.#..####...##...#......##
##....#.##.#.#....##.#...##.#.#
##.#.#.......#.....#.##.#..#..#
#...#...#.##....#...#.........#
##.#.#..##..#..#.###.#.#.##...#
#....##..#.........#.#.....####
#..#....###...#.#.#...#..#..###
#.#..#.#.......#.......#..#...#
###############################
