###############################
#.#.##.#..###.#...#.#...##....#
#....##.#.#.###...........##..#
#.#.#.#.........#...#.##.##.#.#
##......#.#.#...###..##.......#
#.#.#.##.#.###..#...#..##.#...#
###..#......#......#..#..#....#
##.#..#...#.###.#...#.#..##.#.#
#....#...#.#....#.##.......#.##
#..#.##.......##.#.##.#.#....##
#.#.##....#....#.......#.#.#..#
#...#.....#...#..#.#.##...#..##
#.#..#.#.#####...##...#......##
##....#.##.#.#....#.##...##.#.#
##.#.#.......#.....#..#.#.#...#
#...#...#.##....#....#.....#..#
##.###..##..#..#.##..#.#.##...#
##....#..#.........##......#..#
#..#....#.#...#.#....##..#..###
#.#..#.#...........#...#..#...#
###############################
