###############################
#.#.#.####..#.#.#..#.....#.#.##
#.....#.#.##.##..#.....#......#
#.#.#.#........##...#....#.#.##
#.......#.###.#..#.#.....##..##
##.##.##.#.#........##.##.#.#.#
#....#......#.####.#..#.......#
##.#.##.#....#......#.#####.#.#
#.#..#...####...#.##.......#.##
#...#.....#.#.##.#.##.#.#....##
#..#...##.#....#.......#.#.#..#
#..##..#....#.#..#.#.##...#..##
#.##...##.#.##....#.##..#..#.##
#...#.#.##.#.#...#....#.##.#..#
##.###.......#.##.##.#..#....##
#...#...##.#....#.....#..#.#..#
##...##.#..###.#.##..#..#.##..#
#.....#..#..#.#......#.....##.#
##.#....##......#.#...#.#....##
#...##.##...#.####...#.....#..#
###############################
