###############################
#.....#...#.##.#.##..#.#.#.####
#..#.#.#..........##.#.......##
###.....#...##...##....#.#..#.#
#....#.##.##.##.#.##.##.##.#..#
##.##..#.#....#.......#.#.....#
##..#......#....#.#.##...#.#..#
#..##..#.#.##.#.##.#......#.#.#
#..#..#.####..##......#.......#
#.#.#....##.##...#.#.#.####...#
#.#...#.#....##...###...##....#
#..#.#..#.#.......#.......#...#
#.#.###..#.#.#.#.#...#.#...#..#
#....##.....#.#.#..##.#.#.##..#
#.#....#............#..#..#.#.#
#..##.#..###.##..#.#..##...#..#
#.##...##.#.##.##.#.#...#...#.#
##.....#.............#...#...##
#....##.#.#.#..#.##......#....#
#.#.......###.#....#.#...#..#.#
###############################
