###############################
#.#.##.#..###...#.#......#....#
#....##.#.#.###.......#...#...#
#.#.#.#.........#.#.#.##.##...#
##......#.#.#...##...##......##
#.#.#.##.#.##..##...#..##.#...#
##...#......#......#..#..#....#
##.#..#..##.###.#...#.#..##.#.#
#.#..#..##.#....#.##.......#.##
#....#..#.....##.#.##.#.#....##
#.#.#......#...#.......#.#.#..#
#...##....#...#..#.#.##...#..##
#.#..###.##.##...##...#......##
##....#.##.#.#....#.##...##.#.#
##.#.#.......#.....#..#.#.#...#
#...#...#.##....#....#.....#..#
##.#.#..##..#..#.##..#.#.##...#
#....##..#.........##......#..#
#..#....#.#...#.#....##..#..###
#.#..#.#...........#...#..#...#
###############################
