###############################
#.....#...#.##.#.##..#.#.#.####
#..#.#.#..........##.#.......##
###.....#...##...##....#.#..#.#
#....#.##.##.##.#.##.##.##.#..#
##.##..#.#....#.......#.#.....#
##..#......#....#.#.###..#.#..#
#..##..#.#.##.#.##.#......#.#.#
#..#..#.#.##..##......#.......#
#.#.#....##.##...#.#.#.###....#
#.#...#.#....##...###...##....#
#..#.#..#.#.......#.......#...#
#.#.###..#.#.#.#.#...#.#...#..#
#....##.....#.#.#..##.###.#...#
#.#....#............#..#..#...#
#..##.#..###.##..#.#..##...#..#
#.##...##.#.##.##.#.#...#...#.#
##.....#.............#...#...##
#.#..##.#.#.#..#.##......#....#
##.........##.#....#.#...#..#.#
###############################
