###############################
#.#.#..#.####.#...#.##..###...#
#....##...#.###...........#...#
#.#.#.#.........#...#.##.#..#.#
##......#.#.#...###..##.......#
#.#.#.##.#.###..#...#..##.....#
###..#......#......#..#..#.#..#
##.#..#...#.###.#...#.#..##.#.#
#....#...#.#....#.##.......#.##
#..#.#..#.....##.#.##.#.#....##
#.#.###........#.......#.#.#..#
#...#.....#...#..#.#.##...#..##
#.#..#.#.##.##...##...#......##
##....#.##.#.#....#.##...##.#.#
##.#.#.......#.....#..#.#.#...#
#...#...#.##....#....#.....#..#
##.###..##..#..#.##..#.#.##...#
##....#..#.........##......#..#
#..#....#.#...#.#....##..#..###
#.#..#.#...........#...#..#...#
###############################
