###############################
##..#.###.##.###..##.#.###.##.#
#.#.....###...#...###...####..#
#..##.......#.#.....#..#...#..#
#....#######...##..##.#.#.....#
#.........#.#.#..#.#.#....##.##
##...###...##..........####...#
##.###...#####.######.###.#..##
#.##.#......##....#..#######..#
##.##..#.##.#..##.###..#...#..#
#.#.##....###.#.....#..#.###.##
#..##..##...##..#.####..####..#
#..#..#.##.#.##.#..#.#####..###
##..###.#.#..#.#.#..##..#....##
#.##.##....##......##.##.....##
#####...#...##.##........#....#
###.##..#.#.#####.###.#...###.#
#..##....##.###.##.....####.#.#
#..#.#.#.#..#.....##.##...##..#
##.##.#..#...#.#....#.#....#..#
###############################
