###############################
##..#.###.##.####.##.#..##.##.#
#.#.....###...#...###...####..#
#..##.......#.#.....#..#...#..#
#....#######...##..##.#.#.....#
#.........#.#.#..#.#.#....##.##
##...###...##..........####...#
##.###...#####.######.###.#..##
#.####......##....#..#######..#
##.##..#.##.#..##.###..#...#..#
#.#.##....###.#.....#..#.###.##
#..##..##...##..#.####..####..#
#..#..#.##.#.##.#..#.#####..###
##..###.#.#..#.#.#......#....##
#.##..#.....#......##.##.....##
#####...#...##.##........#....#
###.##..#.#.#####.###.#...###.#
#...#....##.###.##......###.#.#
#..#.#.#.#..##....##.##..###..#
##..#.####...#.#....#.#.#..#..#
###############################
