###############################
##...####.##.#....#.##.....####
#.#..####.#..###.##.##.##..#..#
#.#.##.....####.#..##..####..##
#.#.#..###.##..#.####..#..##..#
###.#....#.##.#.##.....#....###
#....#..###..##...#..#####.#..#
##.#....#.#.##...#.##.#.#....##
##.#..#..#.##.##.#...#..###.###
##.##.#.###.##.##.###.#.##...##
#....#..#..###..###..#.##...###
#.##..##..#.#.##...###.###..###
#...#....#..###.####.##..#..###
######.##.###..#..###.###.###.#
#.###...#..#....#..#....#.#.###
#..#.........##.#.#.##.#.#..###
#...#.##.##..##...#..#......###
#.###..#.###..#.....##..#.##..#
#.##..####.##..###..........#.#
##.##.........##..#.####.#....#
###############################
