###############################
##..#.###.##.####.##.#..##.##.#
#.#.....###...#...###...####..#
#..##.......#.#.....#..#...#..#
#....####.##...##..##.#.#.....#
#.....#...#.#.#..#.###....##.##
#....###.#.##..........####...#
##.###...#####.####.#.###.#..##
######......##....#..#######..#
##.##..#.##.#..##.###..#...#..#
###.##....###.#.....#..#.###.##
#..##...#...##..#.####..####..#
#..#..#.##.####.#..#.#####..###
##..###.#.#..#.#.#......#....##
#.##..#............##.##.....##
####....#...#..##........#....#
###.##..#.#.#####.###.#...###.#
#...#....##.###.##......###.#.#
#..#.#.#.#..##..#.##.##..###..#
###.#.####...#.#....#.#.#..#..#
###############################