###############################
#.#.#..#..###.#.#.#.##...#....#
#....##.#.#.###...........##.##
#.#.#.#.........#...#.##.#....#
##......#.#.#...###..##......##
#.#.#.##.#.##..##...#..##.....#
###..#......#......#..#..#....#
##.#..#..######.#...#.#..##.#.#
#....#..##.#....####.......#.##
#..#.#..#.....##.#.##.#.#....##
#.#.#.#....#...#.......#.#.#..#
#...#.....#...#..#.#.##...#..##
#.#..###.##.##...##...#......##
##....#.##.#.#....#.##...##.#.#
##.#.#.......#.....#..#.#.#...#
#...#...#.##....#....#.....#..#
##.#.#..##..#..#.##..#.#.##...#
#....##..#.........##......#..#
#..#....#.#...#.#....##..#..###
#.#..#.#...........#...#..#...#
###############################
