###############################
##..#.###.##.####.##.#..##.##.#
#.#.....###...#...###...####..#
#..##.......#.#.....#..#...#..#
#....#######...##..##.#.#.....#
#.........#.#.#..#.#.#....##.##
##...###...##..........####...#
##.###...#####.######.###.#..##
#.####......##....#..#######..#
##.##..#.##.#..##.###..#...#..#
###.##....###.#.....#..#.###.##
#..##..##...##..#.####..####..#
#..#..#.##.####.#..#.#####..###
##..###.#.#..#.#.#......#....##
#.##..#.....#......##.##.....##
#####...#...##.##........#....#
###.##..#.#.#####.###.#...###.#
#...#....##.###.##......###.#.#
#..#.#.#.#..##....##.##..###..#
##..#.####...#.#....#.#.#..#..#
###############################
